10000000009900069999999900000000
00000009999000000000099900000092
00000009999000000000000000009999
00000009999000000999000009999999
00000000000000060000000000000000