10000000009900009999999900000000
00000009999000000000099900000090
00000009999000000009990000009999
00000009999000000999000009999999
00000000000000060000000000000000
00000009999000000999000009999999
00000000000000060900000000000000
00000000000000060900000000000000
00000009999000000999000009999999
00000000000060060900000000000002